F 220,    100,     2
C 225, 120, 12







        
NO src/north.png  
SO src/south.png                  
                              WE src/west.png			
EA											 src/east.png










           1      11
        1111111111111111111111111
        1000000000110000000000001
        1011000001110000100000001
        1001000000000001 10000001
111111111011000001110000100000001  1111
100000000011000001110111111111111  1001
11110111111111011100000010001      1111
11110111111111011101010010001					
11000000110101011100000010001
10000000000000001100000010001
100000000000000011010100100N1							
1100000111010101111101111000111
11110111 1110101 101111010001
11111111 1111111 111111111111



Esto va al carajo.



Todo esto se tiene que eliminar.
