F 220,    100,     2
C 225, 120, 12







        
NO src/north.png  
SO src/south.png                  
                              WE src/west.png			
EA											 src/east.png










             
        11111111111111111111111111
        10000000001100000000000001
        10110000011100000000000001  111
        10010000000000000000000001  101
1111111110110000011100000000000001  101
1000000000110000011101111011111111  101
11110111111111011100000010001     	111
11110111111111011101010010001					
11000000110101011100000000001     1111
10000000000000001100000010001     1001
100000000000000000010100100S1     1111					
1100000111010101111101111000111
11110111 1110101 101111010001
11111111 1111111 111111111111

