F 220,    100,     2
C 225, 120, 1







        
NO src/north.png
  SO src/south.png               
   
WE src/west.png
EA src/east.png










             
        11111111111111111111111111
        10000000001100000000000001
        10110000011100000000000001  1111
        100100000101000000N000001   1001  
1111111110110000011100000000000001  1011  
1100000000110000011101111011111111  101   111
11111111111111011100000010001       111   101   
11110111111111011101010010001             111
11000000110100011100000000001     1111           
10000000000000001100000010001     1001  
10000000000000000001010010001     1111
11000001110101011111011110001
11111111 1111111 111111111111




