C 1 , 11, 25
F 110,2,109


NO resources/north.png
SO resources/south.png
WE resources/west.png
EA resources/east.png


 111111111111
10000000000001
10000000000001
10000000000N01
10000000000001
1001000111111
10010001
10010001
10000001
 111111