F 255,81,78
C 31,29,24
NO resources/north.png
SO resources/south.png
WE resources/west.png
EA resources/east.png






11111111

11111111
10000001
10000001
10000001
10000001
10010001         111
10010001         101 
10010001         111 
10010001
10011111
100000W1
11111111
