C 1 , 11, 25
F 110,2,109


SO resources/south.png
WE resources/west.png
EA resources/east.png
NO resources/north.png


11111111111111
10000000000001
10000000000001
10000000000001    
10000000000001     
10010001111111    
10010001
10010001
100000E1
11111111
