C 0,255,180
F 254,100,99         


SO resources/south.png         
WE resources/west.png
EA resources/east.png
NO resources/north.png


11111111111111
11111110111111
11111110111111
11111110111111
11111110111111  111
10000000000001   101
10000000100001   101
100000000010001   111    
10000000000001     
10010001111111    
10010001
10010001
100000S1
11111111
