
C 1 , 11, 25
F 110,109,99

NO resources/north.png
SO resources/south.png
WE resources/west.png
EA resources/east.png



    11111111
    10000001                                     
    100N0001                     	      
    10000001     
111110000001
100100011111     111
10010001         101
10010001         111
10000001    
11111111  
