F 220,    100,     2
C 225, 120, 12
NO resources/north.png
SO resources/south.png
WE resources/west.png
EA resources/east.png










             
        11111111111111111111111111
        10000000001100000000000001
        1011000001110000000000001
        100100000101000000N000001
1111111110110000011100000000000001
1100000000110000011101111011111111 
11111111111111011100000010001
11110111111111011101010010001      
11000000110100011100000000001        
10000000000000001100000010001
10000000000000000001010010001
1100000111010101111101111000111  
11110111 1110101 101111010001
11111111 1111111 111111111111
