

SO resources/south.png         
WE resources/west.png

C 0,255,180
F 254,100,99
EA resources/east.png
NO resources/north.png






1111
10N1
1111
      