
C 211 , 11, 25
F 110,109,99

NO resources/north.png
SO resources/south.png
WE resources/west.png
EA resources/east.png



11111111
10000001
10000001
10000001
10000001
10010001         111
10010001         101
10010001         111
10000W01
11111111
